##########
#b  X   X#
#    m   #
#   C   t#
# P      #
# p  % # #
#  C   #t#
#  C  O# #
#  X   #E#
##########
